  _____                    _   _____        __                    
 |_   _|                  | | |  __ \      / _|                   
   | |  ___ _ __ __ _  ___| | | |  | | ___| |_ ___ _ __  ___  ___ 
   | | / __| '__/ _` |/ _ \ | | |  | |/ _ \  _/ _ \ '_ \/ __|/ _ \
  _| |_\__ \ | | (_| |  __/ | | |__| |  __/ ||  __/ | | \__ \  __/
 |_____|___/_|  \__,_|\___|_| |_____/ \___|_| \___|_| |_|___/\___|
                                                                  
                                                                          