       _                       __  __           _            
      | |                     |  \/  |         | |           
      | |_   _ _ __ ___  _ __ | \  / | __ _ ___| |_ ___ _ __ 
  _   | | | | | '_ ` _ \| '_ \| |\/| |/ _` / __| __/ _ \ '__|
 | |__| | |_| | | | | | | |_) | |  | | (_| \__ \ ||  __/ |   
  \____/ \__,_|_| |_| |_| .__/|_|  |_|\__,_|___/\__\___|_|   
                        | |                                  
                        |_|                                  